######B##
###### ##
## ##  ##
## ### ##
## ### ##
A      ##
#########